北京	北京市
天津	天津市
河北	河北省
石家庄	石家庄市
辛集	辛集市
晋州	晋州市
新乐	新乐市
唐山	唐山市
遵化	遵化市
迁安	迁安市
滦州	滦州市
秦皇岛	秦皇岛市
邯郸	邯郸市
武安	武安市
南宫	南宫市
沙河	沙河市
保定	保定市
涿州	涿州市
定州	定州市
安国	安国市
高碑店	高碑店市
张家口	张家口市
平泉	平泉市
沧州	沧州市
泊头	泊头市
任丘	任丘市
黄骅	黄骅市
河间	河间市
廊坊	廊坊市
霸州	霸州市
三河	三河市
衡水	衡水市
深州	深州市
山西	山西省
太原	太原市
古交	古交市
大同	大同区 大同市
阳泉	阳泉市
长治	长治市
晋城	晋城市
高平	高平市
朔州	朔州市
怀仁	怀仁市
晋中	晋中市
介休	介休市
运城	运城市
永济	永济市
河津	河津市
忻州	忻州市
原平	原平市
临汾	临汾市
侯马	侯马市
霍州	霍州市
吕梁	吕梁市
孝义	孝义市
汾阳	汾阳市
呼和浩特	呼和浩特市
包头	包头市
乌海	乌海市
赤峰	赤峰市
通辽	通辽市
霍林郭勒	霍林郭勒市
鄂尔多斯	鄂尔多斯市
呼伦贝尔	呼伦贝尔市
满洲里	满洲里市
牙克石	牙克石市
扎兰屯	扎兰屯市
额尔古纳	额尔古纳市
根河	根河市
巴彦淖尔	巴彦淖尔市
乌兰察布	乌兰察布市
丰镇	丰镇市
乌兰浩特	乌兰浩特市
阿尔山	阿尔山市
二连浩特	二连浩特市
锡林浩特	锡林浩特市
辽宁	辽宁省
沈阳	沈阳市
新民	新民市
大连	大连市
瓦房店	瓦房店市
庄河	庄河市
鞍山	鞍山市
丹东	丹东市
凤城	凤城市
锦州	锦州市
凌海	凌海市
北镇	北镇市
营口	营口市
盖州	盖州市
大石桥	大石桥市
辽阳	辽阳县 辽阳市
灯塔	灯塔市
盘锦	盘锦市
铁岭	铁岭县 铁岭市
调兵山	调兵山市
开原	开原市
北票	北票市
凌源	凌源市
葫芦岛	葫芦岛市
兴城	兴城市
吉林	吉林省
长春	长春市
榆树	榆树市
德惠	德惠市
昌邑	昌邑区 昌邑市
蛟河	蛟河市
桦甸	桦甸市
舒兰	舒兰市
磐石	磐石市
四平	四平市
公主岭	公主岭市
双辽	双辽市
辽源	辽源市
西安	西安区 西安市
通化	通化县 通化市
梅河口	梅河口市
集安	集安市
白山	白山市
临江	临江市
松原	松原市
扶余	扶余市
白城	白城市
洮南	洮南市
延吉	延吉市
图们	图们市
敦化	敦化市
珲春	珲春市
龙井	龙井市
和龙	和龙市
黑龙江	黑龙江省
哈尔滨	哈尔滨市
尚志	尚志市
五常	五常市
齐齐哈尔	齐齐哈尔市
讷河	讷河市
鸡西	鸡西市
虎林	虎林市
密山	密山市
鹤岗	鹤岗市
双鸭山	双鸭山市
大庆	大庆市
铁力	铁力市
佳木斯	佳木斯市
同江	同江市
富锦	富锦市
抚远	抚远市
七台河	七台河市
牡丹江	牡丹江市
绥芬河	绥芬河市
海林	海林市
宁安	宁安市
穆棱	穆棱市
东宁	东宁市
黑河	黑河市
北安	北安市
五大连池	五大连池市
绥化	绥化市
安达	安达市
肇东	肇东市
海伦	海伦市
漠河	漠河市
上海	上海市
江苏	江苏省
南京	南京市
栖霞	栖霞区 栖霞市
无锡	无锡市
江阴	江阴市
宜兴	宜兴市
徐州	徐州市
新沂	新沂市
邳州	邳州市
常州	常州市
溧阳	溧阳市
苏州	苏州市
常熟	常熟市
张家港	张家港市
昆山	昆山市
太仓	太仓市
南通	南通市
启东	启东市
如皋	如皋市
海门	海门市
海安	海安市
连云港	连云港市
淮安	淮安区 淮安市
盐城	盐城市
东台	东台市
扬州	扬州市
仪征	仪征市
高邮	高邮市
镇江	镇江市
丹阳	丹阳市
扬中	扬中市
句容	句容市
泰州	泰州市
兴化	兴化市
靖江	靖江市
泰兴	泰兴市
宿迁	宿迁市
浙江	浙江省
杭州	杭州市
建德	建德市
宁波	宁波市
余姚	余姚市
慈溪	慈溪市
温州	温州市
瑞安	瑞安市
乐清	乐清市
嘉兴	嘉兴市
海宁	海宁市
平湖	平湖市
桐乡	桐乡市
湖州	湖州市
绍兴	绍兴市
诸暨	诸暨市
嵊州	嵊州市
金华	金华市
兰溪	兰溪市
义乌	义乌市
东阳	东阳市
永康	永康市
衢州	衢州市
江山	江山市
舟山	舟山市
台州	台州市
温岭	温岭市
临海	临海市
玉环	玉环市
丽水	丽水市
龙泉	龙泉市
安徽	安徽省
合肥	合肥市
巢湖	巢湖市
蚌埠	蚌埠市
淮南	淮南市
马鞍山	马鞍山市
淮北	淮北市
铜陵	铜陵市
安庆	安庆市
桐城	桐城市
潜山	潜山市
黄山	黄山区 黄山市
滁州	滁州市
天长	天长市
明光	明光市
阜阳	阜阳市
界首	界首市
宿州	宿州市
六安	六安市
亳州	亳州市
池州	池州市
宣城	宣城市
宁国	宁国市
福建	福建省
福州	福州市
福清	福清市
厦门	厦门市
莆田	莆田市
三明	三明市
永安	永安市
泉州	泉州市
石狮	石狮市
晋江	晋江市
南安	南安市
漳州	漳州市
龙海	龙海市
南平	南平市
邵武	邵武市
武夷山	武夷山市
建瓯	建瓯市
龙岩	龙岩市
漳平	漳平市
宁德	宁德市
福安	福安市
福鼎	福鼎市
江西	江西省
南昌	南昌县 南昌市
景德镇	景德镇市
乐平	乐平市
萍乡	萍乡市
九江	九江市
瑞昌	瑞昌市
共青城	共青城市
庐山	庐山市
新余	新余市
鹰潭	鹰潭市
贵溪	贵溪市
赣州	赣州市
瑞金	瑞金市
吉安	吉安县 吉安市
井冈山	井冈山市
宜春	宜春市
丰城	丰城市
樟树	樟树市
高安	高安市
抚州	抚州市
德兴	德兴市
山东	山东省
济南	济南市
青岛	青岛市
胶州	胶州市
平度	平度市
莱西	莱西市
淄博	淄博市
枣庄	枣庄市
滕州	滕州市
烟台	烟台市
龙口	龙口市
莱阳	莱阳市
莱州	莱州市
蓬莱	蓬莱市
招远	招远市
海阳	海阳市
潍坊	潍坊市
青州	青州市
诸城	诸城市
寿光	寿光市
安丘	安丘市
高密	高密市
济宁	济宁市
曲阜	曲阜市
邹城	邹城市
泰安	泰安市
新泰	新泰市
肥城	肥城市
威海	威海市
荣成	荣成市
乳山	乳山市
日照	日照市
莱芜	莱芜市
临沂	临沂市
德州	德州市
乐陵	乐陵市
禹城	禹城市
聊城	聊城市
临清	临清市
滨州	滨州市
邹平	邹平市
菏泽	菏泽市
郑州	郑州市
巩义	巩义市
荥阳	荥阳市
新密	新密市
新郑	新郑市
登封	登封市
开封	开封市
洛阳	洛阳市
偃师	偃师市
平顶山	平顶山市
舞钢	舞钢市
汝州	汝州市
安阳	安阳县 安阳市
林州	林州市
鹤壁	鹤壁市
鹤山	鹤山区 鹤山市
新乡	新乡县 新乡市
卫辉	卫辉市
辉县	辉县市
焦作	焦作市
沁阳	沁阳市
孟州	孟州市
濮阳	濮阳县 濮阳市
许昌	许昌市
禹州	禹州市
长葛	长葛市
漯河	漯河市
三门峡	三门峡市
义马	义马市
灵宝	灵宝市
南阳	南阳市
邓州	邓州市
商丘	商丘市
永城	永城市
信阳	信阳市
周口	周口市
项城	项城市
驻马店	驻马店市
济源	济源市
湖北	湖北省
武汉	武汉市
黄石	黄石市
大冶	大冶市
十堰	十堰市
丹江口	丹江口市
宜昌	宜昌市
宜都	宜都市
当阳	当阳市
枝江	枝江市
襄阳	襄阳市
老河口	老河口市
枣阳	枣阳市
宜城	宜城市
鄂州	鄂州市
荆门	荆门市
钟祥	钟祥市
京山	京山市
孝感	孝感市
应城	应城市
安陆	安陆市
汉川	汉川市
石首	石首市
洪湖	洪湖市
松滋	松滋市
黄冈	黄冈市
麻城	麻城市
武穴	武穴市
咸宁	咸宁市
赤壁	赤壁市
随州	随州市
广水	广水市
利川	利川市
仙桃	仙桃市
潜江	潜江市
天门	天门市
湖南	湖南省
长沙	长沙县 长沙市
浏阳	浏阳市
宁乡	宁乡市
株洲	株洲市
醴陵	醴陵市
湘乡	湘乡市
韶山	韶山市
衡阳	衡阳县 衡阳市
耒阳	耒阳市
常宁	常宁市
武冈	武冈市
岳阳	岳阳县 岳阳市
汨罗	汨罗市
临湘	临湘市
常德	常德市
津市	津市市
张家界	张家界市
益阳	益阳市
资阳	资阳区 资阳市
沅江	沅江市
郴州	郴州市
资兴	资兴市
永州	永州市
怀化	怀化市
洪江	洪江市
娄底	娄底市
冷水江	冷水江市
涟源	涟源市
吉首	吉首市
广东	广东省
广州	广州市
韶关	韶关市
乐昌	乐昌市
南雄	南雄市
深圳	深圳市
珠海	珠海市
汕头	汕头市
佛山	佛山市
江门	江门市
台山	台山市
恩平	恩平市
湛江	湛江市
廉江	廉江市
雷州	雷州市
吴川	吴川市
茂名	茂名市
高州	高州市
化州	化州市
信宜	信宜市
肇庆	肇庆市
四会	四会市
惠州	惠州市
梅州	梅州市
汕尾	汕尾市
陆丰	陆丰市
河源	河源市
阳江	阳江市
阳春	阳春市
清远	清远市
英德	英德市
连州	连州市
东莞	东莞市
潮州	潮州市
揭阳	揭阳市
普宁	普宁市
云浮	云浮市
罗定	罗定市
南宁	南宁市
柳州	柳州市
桂林	桂林市
荔浦	荔浦市
梧州	梧州市
岑溪	岑溪市
北海	北海市
防城港	防城港市
钦州	钦州市
贵港	贵港市
桂平	桂平市
玉林	玉林市
北流	北流市
百色	百色市
靖西	靖西市
贺州	贺州市
河池	河池市
来宾	来宾市
合山	合山市
崇左	崇左市
凭祥	凭祥市
海口	海口市
三亚	三亚市
三沙	三沙市
儋州	儋州市
五指山	五指山市
琼海	琼海市
文昌	文昌市
万宁	万宁市
东方	东方市
重庆	重庆市
四川	四川省
成都	成都市
都江堰	都江堰市
彭州	彭州市
邛崃	邛崃市
崇州	崇州市
简阳	简阳市
自贡	自贡市
攀枝花	攀枝花市
泸州	泸州市
德阳	德阳市
广汉	广汉市
什邡	什邡市
绵竹	绵竹市
绵阳	绵阳市
江油	江油市
广元	广元市
遂宁	遂宁市
内江	内江市
隆昌	隆昌市
乐山	乐山市
峨眉山	峨眉山市
南充	南充市
阆中	阆中市
眉山	眉山市
宜宾	宜宾市
华蓥	华蓥市
达州	达州市
万源	万源市
雅安	雅安市
巴中	巴中市
马尔康	马尔康市
康定	康定市
西昌	西昌市
贵州	贵州省
贵阳	贵阳市
清镇	清镇市
六盘水	六盘水市
盘州	盘州市
遵义	遵义市
赤水	赤水市
仁怀	仁怀市
安顺	安顺市
毕节	毕节市
铜仁	铜仁市
兴义	兴义市
兴仁	兴仁市
凯里	凯里市
都匀	都匀市
福泉	福泉市
云南	云南省
昆明	昆明市
曲靖	曲靖市
宣威	宣威市
玉溪	玉溪市
保山	保山市
腾冲	腾冲市
昭通	昭通市
水富	水富市
丽江	丽江市
普洱	普洱市
临沧	临沧市
个旧	个旧市
开远	开远市
蒙自	蒙自市
弥勒	弥勒市
景洪	景洪市
瑞丽	瑞丽市
泸水	泸水市
香格里拉	香格里拉市
拉萨	拉萨市
日喀则	日喀则市
昌都	昌都市
林芝	林芝市
山南	山南市
那曲	那曲市
陕西	陕西省
铜川	铜川市
宝鸡	宝鸡市
咸阳	咸阳市
兴平	兴平市
彬州	彬州市
渭南	渭南市
韩城	韩城市
华阴	华阴市
延安	延安市
汉中	汉中市
榆林	榆林市
神木	神木市
安康	安康市
商洛	商洛市
甘肃	甘肃省
兰州	兰州市
嘉峪关	嘉峪关市
金昌	金昌市
白银	白银区 白银市
天水	天水市
武威	武威市
张掖	张掖市
平凉	平凉市
华亭	华亭市
酒泉	酒泉市
玉门	玉门市
敦煌	敦煌市
庆阳	庆阳市
定西	定西市
陇南	陇南市
合作	合作市
青海	青海省
西宁	西宁市
海东	海东市
格尔木	格尔木市
德令哈	德令哈市
茫崖	茫崖市
银川	银川市
灵武	灵武市
石嘴山	石嘴山市
吴忠	吴忠市
青铜峡	青铜峡市
固原	固原市
中卫	中卫市
乌鲁木齐	乌鲁木齐县 乌鲁木齐市
克拉玛依	克拉玛依区 克拉玛依市
吐鲁番	吐鲁番市
哈密	哈密市
阜康	阜康市
博乐	博乐市
阿拉山口	阿拉山口市
库尔勒	库尔勒市
阿克苏	阿克苏市
阿图什	阿图什市
喀什	喀什市
和田	和田县 和田市
伊宁	伊宁县 伊宁市
奎屯	奎屯市
霍尔果斯	霍尔果斯市
塔城	塔城市
乌苏	乌苏市
阿勒泰	阿勒泰市
石河子	石河子市
阿拉尔	阿拉尔市
图木舒克	图木舒克市
五家渠	五家渠市
北屯	北屯市
铁门关	铁门关市
双河	双河市
可克达拉	可克达拉市
昆玉	昆玉市
台湾	台湾省
广西	广西壮族自治区
内蒙古	内蒙古自治区
宁夏	宁夏回族自治区
新疆	新疆维吾尔自治区
西藏	西藏自治区
香港	香港特别行政区
澳门	澳门特别行政区