京	北京市
北京	北京市
东城	东城区
西城	西城区
朝阳	朝阳区 朝阳市 朝阳县
丰台	丰台区
石景山	石景山区
海淀	海淀区
门头沟	门头沟区
房山	房山区
通州	通州区
顺义	顺义区
昌平	昌平区
大兴	大兴区
怀柔	怀柔区
平谷	平谷区
密云	密云区
延庆	延庆区
天津	天津市
和平	和平县 和平区
河东	河东区
河西	河西区
南开	南开区
河北	河北省
红桥	红桥区
东丽	东丽区
西青	西青区
津南	津南区
北辰	北辰区
武清	武清区
宝坻	宝坻区
滨海新	滨海新区
宁河	宁河区
静海	静海区
蓟州	蓟州区
石家庄	石家庄市
长安	长安区
桥西	桥西区
新华	新华区
井陉矿	井陉矿区
裕华	裕华区
藁城	藁城区
鹿泉	鹿泉区
栾城	栾城区
井陉	井陉县
正定	正定县
行唐	行唐县
灵寿	灵寿县
高邑	高邑县
深泽	深泽县
赞皇	赞皇县
无极	无极县
平山	平山县 平山区
元氏	元氏县
赵	赵县
辛集	辛集市
晋州	晋州市
新乐	新乐市
唐山	唐山市
路南	路南区
路北	路北区
古冶	古冶区
开平	开平市 开平区
丰南	丰南区
丰润	丰润区
曹妃甸	曹妃甸区
滦南	滦南县
乐亭	乐亭县
迁西	迁西县
玉田	玉田县
遵化	遵化市
迁安	迁安市
滦州	滦州市
秦皇岛	秦皇岛市
海港	海港区
山海关	山海关区
北戴河	北戴河区
抚宁	抚宁区
昌黎	昌黎县
卢龙	卢龙县
邯郸	邯郸市
邯山	邯山区
丛台	丛台区
复兴	复兴区
峰峰矿	峰峰矿区
肥乡	肥乡区
永年	永年区
临漳	临漳县
成安	成安县
大名	大名县
涉	涉县
磁	磁县
邱	邱县
鸡泽	鸡泽县
广平	广平县
馆陶	馆陶县
魏	魏县
曲周	曲周县
武安	武安市
邢台	邢台市 邢台县
桥东	桥东区
临城	临城县
内丘	内丘县
柏乡	柏乡县
隆尧	隆尧县
任	任县
南和	南和县
宁晋	宁晋县
巨鹿	巨鹿县
新河	新河县
广宗	广宗县
平乡	平乡县
威	威县
清河	清河县 清河区
临西	临西县
南宫	南宫市
沙河	沙河市
保定	保定市
竞秀	竞秀区
莲池	莲池区
满城	满城区
清苑	清苑区
徐水	徐水区
涞水	涞水县
阜平	阜平县
定兴	定兴县
唐	唐县
高阳	高阳县
容城	容城县
涞源	涞源县
望都	望都县
安新	安新县
易	易县
曲阳	曲阳县
蠡	蠡县
顺平	顺平县
博野	博野县
雄	雄县
涿州	涿州市
定州	定州市
安国	安国市
高碑店	高碑店市
张家口	张家口市
宣化	宣化区
下花园	下花园区
万全	万全区
崇礼	崇礼区
张北	张北县
康保	康保县
沽源	沽源县
尚义	尚义县
蔚	蔚县
阳原	阳原县
怀安	怀安县
怀来	怀来县
涿鹿	涿鹿县
赤城	赤城县
承德	承德市 承德县
双桥	双桥区
双滦	双滦区
鹰手营子矿	鹰手营子矿区
兴隆	兴隆县
滦平	滦平县
隆化	隆化县
平泉	平泉市
沧州	沧州市
运河	运河区
沧	沧县
青	青县
东光	东光县
海兴	海兴县
盐山	盐山县
肃宁	肃宁县
南皮	南皮县
吴桥	吴桥县
献	献县
泊头	泊头市
任丘	任丘市
黄骅	黄骅市
河间	河间市
廊坊	廊坊市
安次	安次区
广阳	广阳区
固安	固安县
永清	永清县
香河	香河县
大城	大城县
文安	文安县
霸州	霸州市
三河	三河市
衡水	衡水市
桃城	桃城区
冀州	冀州区
枣强	枣强县
武邑	武邑县
武强	武强县
饶阳	饶阳县
安平	安平县
故城	故城县
景	景县
阜城	阜城县
深州	深州市
山西	山西省
太原	太原市
小店	小店区
迎泽	迎泽区
杏花岭	杏花岭区
尖草坪	尖草坪区
万柏林	万柏林区
晋源	晋源区
清徐	清徐县
阳曲	阳曲县
娄烦	娄烦县
古交	古交市
大同	大同区 大同市
新荣	新荣区
平城	平城区
云冈	云冈区
云州	云州区
阳高	阳高县
天镇	天镇县
广灵	广灵县
灵丘	灵丘县
浑源	浑源县
左云	左云县
阳泉	阳泉市
城	城区
矿	矿区
郊	郊区
平定	平定县
盂	盂县
长治	长治市
潞州	潞州区
上党	上党区
屯留	屯留区
潞城	潞城区
襄垣	襄垣县
平顺	平顺县
黎城	黎城县
壶关	壶关县
长子	长子县
武乡	武乡县
沁	沁县
沁源	沁源县
晋城	晋城市
沁水	沁水县
阳城	阳城县
陵川	陵川县
泽州	泽州县
高平	高平市
朔州	朔州市
朔城	朔城区
平鲁	平鲁区
山阴	山阴县
应	应县
右玉	右玉县
怀仁	怀仁市
晋中	晋中市
榆次	榆次区
榆社	榆社县
左权	左权县
和顺	和顺县
昔阳	昔阳县
寿阳	寿阳县
太谷	太谷县
祁	祁县
平遥	平遥县
灵石	灵石县
介休	介休市
运城	运城市
盐湖	盐湖区
临猗	临猗县
万荣	万荣县
闻喜	闻喜县
稷山	稷山县
新绛	新绛县
绛	绛县
垣曲	垣曲县
夏	夏县
平陆	平陆县
芮城	芮城县
永济	永济市
河津	河津市
忻州	忻州市
忻府	忻府区
定襄	定襄县
五台	五台县
代	代县
繁峙	繁峙县
宁武	宁武县
静乐	静乐县
神池	神池县
五寨	五寨县
岢岚	岢岚县
河曲	河曲县
保德	保德县
偏关	偏关县
原平	原平市
临汾	临汾市
尧都	尧都区
曲沃	曲沃县
翼城	翼城县
襄汾	襄汾县
洪洞	洪洞县
古	古县
安泽	安泽县
浮山	浮山县
吉	吉县
乡宁	乡宁县
大宁	大宁县
隰	隰县
永和	永和县
蒲	蒲县
汾西	汾西县
侯马	侯马市
霍州	霍州市
吕梁	吕梁市
离石	离石区
文水	文水县
交城	交城县
兴	兴县
临	临县
柳林	柳林县
石楼	石楼县
岚	岚县
方山	方山县
中阳	中阳县
交口	交口县
孝义	孝义市
汾阳	汾阳市
呼和浩特	呼和浩特市
新城	新城区
回民	回民区
玉泉	玉泉区
赛罕	赛罕区
托克托	托克托县
和林格尔	和林格尔县
清水河	清水河县
武川	武川县
包头	包头市
东河	东河区
昆都仑	昆都仑区
青山	青山区
石拐	石拐区
白云鄂博矿	白云鄂博矿区
九原	九原区
固阳	固阳县
乌海	乌海市
海勃湾	海勃湾区
海南	海南省 海南藏族自治州
乌达	乌达区
赤峰	赤峰市
红山	红山区
元宝山	元宝山区
松山	松山区
林西	林西县
宁城	宁城县
通辽	通辽市
科尔沁	科尔沁区
开鲁	开鲁县
霍林郭勒	霍林郭勒市
鄂尔多斯	鄂尔多斯市
东胜	东胜区
康巴什	康巴什区
呼伦贝尔	呼伦贝尔市
海拉尔	海拉尔区
扎赉诺尔	扎赉诺尔区
满洲里	满洲里市
牙克石	牙克石市
扎兰屯	扎兰屯市
额尔古纳	额尔古纳市
根河	根河市
巴彦淖尔	巴彦淖尔市
临河	临河区
五原	五原县
磴口	磴口县
乌兰察布	乌兰察布市
集宁	集宁区
卓资	卓资县
化德	化德县
商都	商都县
兴和	兴和县
凉城	凉城县
丰镇	丰镇市
乌兰浩特	乌兰浩特市
阿尔山	阿尔山市
突泉	突泉县
二连浩特	二连浩特市
锡林浩特	锡林浩特市
多伦	多伦县
辽宁	辽宁省
沈阳	沈阳市
沈河	沈河区
大东	大东区
皇姑	皇姑区
铁西	铁西区
苏家屯	苏家屯区
浑南	浑南区
沈北新	沈北新区
于洪	于洪区
辽中	辽中区
康平	康平县
法库	法库县
新民	新民市
大连	大连市
中山	中山市 中山区
西岗	西岗区
沙河口	沙河口区
甘井子	甘井子区
旅顺口	旅顺口区
金州	金州区
普兰店	普兰店区
长海	长海县
瓦房店	瓦房店市
庄河	庄河市
鞍山	鞍山市
铁东	铁东区
立山	立山区
千山	千山区
台安	台安县
海城	海城市 海城区
抚顺	抚顺市 抚顺县
新抚	新抚区
东洲	东洲区
望花	望花区
顺城	顺城区
本溪	本溪市 本溪满族自治县
溪湖	溪湖区
明山	明山区
南芬	南芬区
丹东	丹东市
元宝	元宝区
振兴	振兴区
振安	振安区
东港	东港市 东港区
凤城	凤城市
锦州	锦州市
古塔	古塔区
凌河	凌河区
太和	太和区 太和县
黑山	黑山县
义	义县
凌海	凌海市
北镇	北镇市
营口	营口市
站前	站前区
西市	西市区
鲅鱼圈	鲅鱼圈区
老边	老边区
盖州	盖州市
大石桥	大石桥市
阜新	阜新市 阜新蒙古族自治县
海州	海州区
新邱	新邱区
太平	太平区
清河门	清河门区
细河	细河区
彰武	彰武县
辽阳	辽阳县 辽阳市
白塔	白塔区
文圣	文圣区
宏伟	宏伟区
弓长岭	弓长岭区
太子河	太子河区
灯塔	灯塔市
盘锦	盘锦市
双台子	双台子区
兴隆台	兴隆台区
大洼	大洼区
盘山	盘山县
铁岭	铁岭县 铁岭市
银州	银州区
西丰	西丰县
昌图	昌图县
调兵山	调兵山市
开原	开原市
双塔	双塔区
龙城	龙城区
建平	建平县
北票	北票市
凌源	凌源市
葫芦岛	葫芦岛市
连山	连山区 连山壮族瑶族自治县
龙港	龙港区
南票	南票区
绥中	绥中县
建昌	建昌县
兴城	兴城市
吉林	吉林省
长春	长春市
南关	南关区
宽城	宽城区 宽城满族自治县
二道	二道区
绿园	绿园区
双阳	双阳区
九台	九台区
农安	农安县
榆树	榆树市
德惠	德惠市
昌邑	昌邑区 昌邑市
龙潭	龙潭区
船营	船营区
丰满	丰满区
永吉	永吉县
蛟河	蛟河市
桦甸	桦甸市
舒兰	舒兰市
磐石	磐石市
四平	四平市
梨树	梨树区 梨树县
公主岭	公主岭市
双辽	双辽市
辽源	辽源市
龙山	龙山区 龙山县
西安	西安区 西安市
东丰	东丰县
东辽	东辽县
通化	通化县 通化市
东昌	东昌区
二道江	二道江区
辉南	辉南县
柳河	柳河县
梅河口	梅河口市
集安	集安市
白山	白山市
浑江	浑江区
江源	江源区
抚松	抚松县
靖宇	靖宇县
临江	临江市
松原	松原市
宁江	宁江区
长岭	长岭县
乾安	乾安县
扶余	扶余市
白城	白城市
洮北	洮北区
镇赉	镇赉县
通榆	通榆县
洮南	洮南市
大安	大安市 大安区
延吉	延吉市
图们	图们市
敦化	敦化市
珲春	珲春市
龙井	龙井市
和龙	和龙市
汪清	汪清县
安图	安图县
黑龙江	黑龙江省
哈尔滨	哈尔滨市
道里	道里区
南岗	南岗区
道外	道外区
平房	平房区
松北	松北区
香坊	香坊区
呼兰	呼兰区
阿城	阿城区
双城	双城区
依兰	依兰县
方正	方正县
宾	宾县
巴彦	巴彦县
木兰	木兰县
通河	通河县
延寿	延寿县
尚志	尚志市
五常	五常市
齐齐哈尔	齐齐哈尔市
龙沙	龙沙区
建华	建华区
铁锋	铁锋区
昂昂溪	昂昂溪区
富拉尔基	富拉尔基区
碾子山	碾子山区
梅里斯达斡尔族	梅里斯达斡尔族区
龙江	龙江县
依安	依安县
泰来	泰来县
甘南	甘南县 甘南藏族自治州
富裕	富裕县
克山	克山县
克东	克东县
拜泉	拜泉县
讷河	讷河市
鸡西	鸡西市
鸡冠	鸡冠区
恒山	恒山区
滴道	滴道区
城子河	城子河区
麻山	麻山区
鸡东	鸡东县
虎林	虎林市
密山	密山市
鹤岗	鹤岗市
向阳	向阳区
工农	工农区
南山	南山区
兴安	兴安县 兴安区
东山	东山县 东山区
兴山	兴山区 兴山县
萝北	萝北县
绥滨	绥滨县
双鸭山	双鸭山市
尖山	尖山区
岭东	岭东区
四方台	四方台区
宝山	宝山区
集贤	集贤县
友谊	友谊县
宝清	宝清县
饶河	饶河县
大庆	大庆市
萨尔图	萨尔图区
龙凤	龙凤区
让胡路	让胡路区
红岗	红岗区
肇州	肇州县
肇源	肇源县
林甸	林甸县
伊春	伊春市 伊春区
南岔	南岔区
友好	友好区
西林	西林区 西林县
翠峦	翠峦区
新青	新青区
美溪	美溪区
金山屯	金山屯区
五营	五营区
乌马河	乌马河区
汤旺河	汤旺河区
带岭	带岭区
乌伊岭	乌伊岭区
红星	红星区
上甘岭	上甘岭区
嘉荫	嘉荫县
铁力	铁力市
佳木斯	佳木斯市
前进	前进区
东风	东风区
桦南	桦南县
桦川	桦川县
汤原	汤原县
同江	同江市
富锦	富锦市
抚远	抚远市
七台河	七台河市
新兴	新兴县 新兴区
桃山	桃山区
茄子河	茄子河区
勃利	勃利县
牡丹江	牡丹江市
东安	东安区 东安县
阳明	阳明区
爱民	爱民区
林口	林口县
绥芬河	绥芬河市
海林	海林市
宁安	宁安市
穆棱	穆棱市
东宁	东宁市
黑河	黑河市
爱辉	爱辉区
嫩江	嫩江县
逊克	逊克县
孙吴	孙吴县
北安	北安市
五大连池	五大连池市
绥化	绥化市
北林	北林区
望奎	望奎县
兰西	兰西县
青冈	青冈县
庆安	庆安县
明水	明水县
绥棱	绥棱县
安达	安达市
肇东	肇东市
海伦	海伦市
大兴安岭地	大兴安岭地区
漠河	漠河市
呼玛	呼玛县
塔河	塔河县
上海	上海市
黄浦	黄浦区
徐汇	徐汇区
长宁	长宁区 长宁县
静安	静安区
普陀	普陀区
虹口	虹口区
杨浦	杨浦区
闵行	闵行区
嘉定	嘉定区
浦东新	浦东新区
金山	金山区
松江	松江区
青浦	青浦区
奉贤	奉贤区
崇明	崇明区
江苏	江苏省
南京	南京市
玄武	玄武区
秦淮	秦淮区
建邺	建邺区
鼓楼	鼓楼区
浦口	浦口区
栖霞	栖霞区 栖霞市
雨花台	雨花台区
江宁	江宁区
六合	六合区
溧水	溧水区
高淳	高淳区
无锡	无锡市
锡山	锡山区
惠山	惠山区
滨湖	滨湖区
梁溪	梁溪区
新吴	新吴区
江阴	江阴市
宜兴	宜兴市
徐州	徐州市
云龙	云龙区 云龙县
贾汪	贾汪区
泉山	泉山区
铜山	铜山区
丰	丰县
沛	沛县
睢宁	睢宁县
新沂	新沂市
邳州	邳州市
常州	常州市
天宁	天宁区
钟楼	钟楼区
新北	新北区
武进	武进区
金坛	金坛区
溧阳	溧阳市
苏州	苏州市
虎丘	虎丘区
吴中	吴中区
相城	相城区
姑苏	姑苏区
吴江	吴江区
常熟	常熟市
张家港	张家港市
昆山	昆山市
太仓	太仓市
南通	南通市
崇川	崇川区
港闸	港闸区
如东	如东县
启东	启东市
如皋	如皋市
海门	海门市
海安	海安市
连云港	连云港市
连云	连云区
赣榆	赣榆区
东海	东海县
灌云	灌云县
灌南	灌南县
淮安	淮安区 淮安市
淮阴	淮阴区
清江浦	清江浦区
洪泽	洪泽区
涟水	涟水县
盱眙	盱眙县
金湖	金湖县
盐城	盐城市
亭湖	亭湖区
盐都	盐都区
大丰	大丰区
响水	响水县
滨海	滨海县
阜宁	阜宁县
射阳	射阳县
建湖	建湖县
东台	东台市
扬州	扬州市
广陵	广陵区
邗江	邗江区
江都	江都区
宝应	宝应县
仪征	仪征市
高邮	高邮市
镇江	镇江市
京口	京口区
润州	润州区
丹徒	丹徒区
丹阳	丹阳市
扬中	扬中市
句容	句容市
泰州	泰州市
海陵	海陵区
高港	高港区
姜堰	姜堰区
兴化	兴化市
靖江	靖江市
泰兴	泰兴市
宿迁	宿迁市
宿城	宿城区
宿豫	宿豫区
沭阳	沭阳县
泗阳	泗阳县
泗洪	泗洪县
浙江	浙江省
杭州	杭州市
上城	上城区
下城	下城区
江干	江干区
拱墅	拱墅区
西湖	西湖区
滨江	滨江区
萧山	萧山区
余杭	余杭区
富阳	富阳区
临安	临安区
桐庐	桐庐县
淳安	淳安县
建德	建德市
宁波	宁波市
海曙	海曙区
江北	江北区
北仑	北仑区
镇海	镇海区
鄞州	鄞州区
奉化	奉化区
象山	象山区 象山县
宁海	宁海县
余姚	余姚市
慈溪	慈溪市
温州	温州市
鹿城	鹿城区
龙湾	龙湾区
瓯海	瓯海区
洞头	洞头区
永嘉	永嘉县
平阳	平阳县
苍南	苍南县
文成	文成县
泰顺	泰顺县
瑞安	瑞安市
乐清	乐清市
嘉兴	嘉兴市
南湖	南湖区
秀洲	秀洲区
嘉善	嘉善县
海盐	海盐县
海宁	海宁市
平湖	平湖市
桐乡	桐乡市
湖州	湖州市
吴兴	吴兴区
南浔	南浔区
德清	德清县
长兴	长兴县
安吉	安吉县
绍兴	绍兴市
越城	越城区
柯桥	柯桥区
上虞	上虞区
新昌	新昌县
诸暨	诸暨市
嵊州	嵊州市
金华	金华市
婺城	婺城区
金东	金东区
武义	武义县
浦江	浦江县
磐安	磐安县
兰溪	兰溪市
义乌	义乌市
东阳	东阳市
永康	永康市
衢州	衢州市
柯城	柯城区
衢江	衢江区
常山	常山县
开化	开化县
龙游	龙游县
江山	江山市
舟山	舟山市
定海	定海区
岱山	岱山县
嵊泗	嵊泗县
台州	台州市
椒江	椒江区
黄岩	黄岩区
路桥	路桥区
三门	三门县
天台	天台县
仙居	仙居县
温岭	温岭市
临海	临海市
玉环	玉环市
丽水	丽水市
莲都	莲都区
青田	青田县
缙云	缙云县
遂昌	遂昌县
松阳	松阳县
云和	云和县
庆元	庆元县
龙泉	龙泉市
安徽	安徽省
合肥	合肥市
瑶海	瑶海区
庐阳	庐阳区
蜀山	蜀山区
包河	包河区
长丰	长丰县
肥东	肥东县
肥西	肥西县
庐江	庐江县
巢湖	巢湖市
芜湖	芜湖市 芜湖县
镜湖	镜湖区
弋江	弋江区
鸠江	鸠江区
三山	三山区
繁昌	繁昌县
南陵	南陵县
无为	无为县
蚌埠	蚌埠市
龙子湖	龙子湖区
蚌山	蚌山区
禹会	禹会区
淮上	淮上区
怀远	怀远县
五河	五河县
固镇	固镇县
淮南	淮南市
大通	大通区 大通回族土族自治县
田家庵	田家庵区
谢家集	谢家集区
八公山	八公山区
潘集	潘集区
凤台	凤台县
寿	寿县
马鞍山	马鞍山市
花山	花山区
雨山	雨山区
博望	博望区
当涂	当涂县
含山	含山县
和	和县
淮北	淮北市
杜集	杜集区
相山	相山区
烈山	烈山区
濉溪	濉溪县
铜陵	铜陵市
铜官	铜官区
义安	义安区
枞阳	枞阳县
安庆	安庆市
迎江	迎江区
大观	大观区
宜秀	宜秀区
怀宁	怀宁县
太湖	太湖县
宿松	宿松县
望江	望江县
岳西	岳西县
桐城	桐城市
潜山	潜山市
黄山	黄山区 黄山市
屯溪	屯溪区
徽州	徽州区
歙	歙县
休宁	休宁县
黟	黟县
祁门	祁门县
滁州	滁州市
琅琊	琅琊区
南谯	南谯区
来安	来安县
全椒	全椒县
定远	定远县
凤阳	凤阳县
天长	天长市
明光	明光市
阜阳	阜阳市
颍州	颍州区
颍东	颍东区
颍泉	颍泉区
临泉	临泉县
阜南	阜南县
颍上	颍上县
界首	界首市
宿州	宿州市
埇桥	埇桥区
砀山	砀山县
萧	萧县
灵璧	灵璧县
泗	泗县
六安	六安市
金安	金安区
裕安	裕安区
叶集	叶集区
霍邱	霍邱县
舒城	舒城县
金寨	金寨县
霍山	霍山县
亳州	亳州市
谯城	谯城区
涡阳	涡阳县
蒙城	蒙城县
利辛	利辛县
池州	池州市
贵池	贵池区
东至	东至县
石台	石台县
青阳	青阳县
宣城	宣城市
宣州	宣州区
郎溪	郎溪县
广德	广德县
泾	泾县
绩溪	绩溪县
旌德	旌德县
宁国	宁国市
福建	福建省
福州	福州市
台江	台江区 台江县
仓山	仓山区
马尾	马尾区
晋安	晋安区
长乐	长乐区
闽侯	闽侯县
连江	连江县
罗源	罗源县
闽清	闽清县
永泰	永泰县
平潭	平潭县
福清	福清市
厦门	厦门市
思明	思明区
海沧	海沧区
湖里	湖里区
集美	集美区
同安	同安区
翔安	翔安区
莆田	莆田市
城厢	城厢区
涵江	涵江区
荔城	荔城区
秀屿	秀屿区
仙游	仙游县
三明	三明市
梅列	梅列区
三元	三元区
明溪	明溪县
清流	清流县
宁化	宁化县
大田	大田县
尤溪	尤溪县
沙	沙县
将乐	将乐县
泰宁	泰宁县
建宁	建宁县
永安	永安市
泉州	泉州市
鲤城	鲤城区
丰泽	丰泽区
洛江	洛江区
泉港	泉港区
惠安	惠安县
安溪	安溪县
永春	永春县
德化	德化县
金门	金门县
石狮	石狮市
晋江	晋江市
南安	南安市
漳州	漳州市
芗城	芗城区
龙文	龙文区
云霄	云霄县
漳浦	漳浦县
诏安	诏安县
长泰	长泰县
南靖	南靖县
平和	平和县
华安	华安县
龙海	龙海市
南平	南平市
延平	延平区
建阳	建阳区
顺昌	顺昌县
浦城	浦城县
光泽	光泽县
松溪	松溪县
政和	政和县
邵武	邵武市
武夷山	武夷山市
建瓯	建瓯市
龙岩	龙岩市
新罗	新罗区
永定	永定区
长汀	长汀县
上杭	上杭县
武平	武平县
连城	连城县
漳平	漳平市
宁德	宁德市
蕉城	蕉城区
霞浦	霞浦县
古田	古田县
屏南	屏南县
寿宁	寿宁县
周宁	周宁县
柘荣	柘荣县
福安	福安市
福鼎	福鼎市
江西	江西省
南昌	南昌县 南昌市
东湖	东湖区
青云谱	青云谱区
湾里	湾里区
青山湖	青山湖区
新建	新建区
安义	安义县
进贤	进贤县
景德镇	景德镇市
昌江	昌江区 昌江黎族自治县
珠山	珠山区
浮梁	浮梁县
乐平	乐平市
萍乡	萍乡市
安源	安源区
湘东	湘东区
莲花	莲花县
上栗	上栗县
芦溪	芦溪县
九江	九江市
濂溪	濂溪区
浔阳	浔阳区
柴桑	柴桑区
武宁	武宁县
修水	修水县
永修	永修县
德安	德安县
都昌	都昌县
湖口	湖口县
彭泽	彭泽县
瑞昌	瑞昌市
共青城	共青城市
庐山	庐山市
新余	新余市
渝水	渝水区
分宜	分宜县
鹰潭	鹰潭市
月湖	月湖区
余江	余江区
贵溪	贵溪市
赣州	赣州市
章贡	章贡区
南康	南康区
赣县	赣县区
信丰	信丰县
大余	大余县
上犹	上犹县
崇义	崇义县
安远	安远县
龙南	龙南县
定南	定南县
全南	全南县
宁都	宁都县
于都	于都县
兴国	兴国县
会昌	会昌县
寻乌	寻乌县
石城	石城县
瑞金	瑞金市
吉安	吉安县 吉安市
吉州	吉州区
青原	青原区
吉水	吉水县
峡江	峡江县
新干	新干县
永丰	永丰县
泰和	泰和县
遂川	遂川县
万安	万安县
安福	安福县
永新	永新县
井冈山	井冈山市
宜春	宜春市
袁州	袁州区
奉新	奉新县
万载	万载县
上高	上高县
宜丰	宜丰县
靖安	靖安县
铜鼓	铜鼓县
丰城	丰城市
樟树	樟树市
高安	高安市
抚州	抚州市
临川	临川区
东乡	东乡区 东乡族自治县
南城	南城县
黎川	黎川县
南丰	南丰县
崇仁	崇仁县
乐安	乐安县
宜黄	宜黄县
金溪	金溪县
资溪	资溪县
广昌	广昌县
上饶	上饶市 上饶县
信州	信州区
广丰	广丰区
玉山	玉山县
铅山	铅山县
横峰	横峰县
弋阳	弋阳县
余干	余干县
鄱阳	鄱阳县
万年	万年县
婺源	婺源县
德兴	德兴市
山东	山东省
济南	济南市
历下	历下区
市中	市中区
槐荫	槐荫区
天桥	天桥区
历城	历城区
长清	长清区
章丘	章丘区
济阳	济阳区
平阴	平阴县
商河	商河县
青岛	青岛市
市南	市南区
市北	市北区
黄岛	黄岛区
崂山	崂山区
李沧	李沧区
城阳	城阳区
即墨	即墨区
胶州	胶州市
平度	平度市
莱西	莱西市
淄博	淄博市
淄川	淄川区
张店	张店区
博山	博山区
临淄	临淄区
周村	周村区
桓台	桓台县
高青	高青县
沂源	沂源县
枣庄	枣庄市
薛城	薛城区
峄城	峄城区
台儿庄	台儿庄区
山亭	山亭区
滕州	滕州市
东营	东营市 东营区
河口	河口区 河口瑶族自治县
垦利	垦利区
利津	利津县
广饶	广饶县
烟台	烟台市
芝罘	芝罘区
福山	福山区
牟平	牟平区
莱山	莱山区
长岛	长岛县
龙口	龙口市
莱阳	莱阳市
莱州	莱州市
蓬莱	蓬莱市
招远	招远市
海阳	海阳市
潍坊	潍坊市
潍城	潍城区
寒亭	寒亭区
坊子	坊子区
奎文	奎文区
临朐	临朐县
昌乐	昌乐县
青州	青州市
诸城	诸城市
寿光	寿光市
安丘	安丘市
高密	高密市
济宁	济宁市
任城	任城区
兖州	兖州区
微山	微山县
鱼台	鱼台县
金乡	金乡县
嘉祥	嘉祥县
汶上	汶上县
泗水	泗水县
梁山	梁山县
曲阜	曲阜市
邹城	邹城市
泰安	泰安市
泰山	泰山区
岱岳	岱岳区
宁阳	宁阳县
东平	东平县
新泰	新泰市
肥城	肥城市
威海	威海市
环翠	环翠区
文登	文登区
荣成	荣成市
乳山	乳山市
日照	日照市
岚山	岚山区
五莲	五莲县
莒	莒县
莱芜	莱芜市
莱城	莱城区
钢城	钢城区
临沂	临沂市
兰山	兰山区
罗庄	罗庄区
沂南	沂南县
郯城	郯城县
沂水	沂水县
兰陵	兰陵县
费	费县
平邑	平邑县
莒南	莒南县
蒙阴	蒙阴县
临沭	临沭县
德州	德州市
德城	德城区
陵城	陵城区
宁津	宁津县
庆云	庆云县
临邑	临邑县
齐河	齐河县
平原	平原县
夏津	夏津县
武城	武城县
乐陵	乐陵市
禹城	禹城市
聊城	聊城市
东昌府	东昌府区
阳谷	阳谷县
莘	莘县
茌平	茌平县
东阿	东阿县
冠	冠县
高唐	高唐县
临清	临清市
滨州	滨州市
滨城	滨城区
沾化	沾化区
惠民	惠民县
阳信	阳信县
无棣	无棣县
博兴	博兴县
邹平	邹平市
菏泽	菏泽市
牡丹	牡丹区
定陶	定陶区
曹	曹县
单	单县
成武	成武县
巨野	巨野县
郓城	郓城县
鄄城	鄄城县
东明	东明县
河南	河南省 河南蒙古族自治县
郑州	郑州市
中原	中原区
二七	二七区
管城回族	管城回族区
金水	金水区
上街	上街区
惠济	惠济区
中牟	中牟县
巩义	巩义市
荥阳	荥阳市
新密	新密市
新郑	新郑市
登封	登封市
开封	开封市
龙亭	龙亭区
顺河回族	顺河回族区
禹王台	禹王台区
祥符	祥符区
杞	杞县
通许	通许县
尉氏	尉氏县
兰考	兰考县
洛阳	洛阳市
老城	老城区
西工	西工区
瀍河回族	瀍河回族区
涧西	涧西区
吉利	吉利区
洛龙	洛龙区
孟津	孟津县
新安	新安县
栾川	栾川县
嵩	嵩县
汝阳	汝阳县
宜阳	宜阳县
洛宁	洛宁县
伊川	伊川县
偃师	偃师市
平顶山	平顶山市
卫东	卫东区
石龙	石龙区
湛河	湛河区
宝丰	宝丰县
叶	叶县
鲁山	鲁山县
郏	郏县
舞钢	舞钢市
汝州	汝州市
安阳	安阳县 安阳市
文峰	文峰区
北关	北关区
殷都	殷都区
龙安	龙安区
汤阴	汤阴县
滑	滑县
内黄	内黄县
林州	林州市
鹤壁	鹤壁市
鹤山	鹤山区 鹤山市
山城	山城区
淇滨	淇滨区
浚	浚县
淇	淇县
新乡	新乡县 新乡市
红旗	红旗区
卫滨	卫滨区
凤泉	凤泉区
牧野	牧野区
获嘉	获嘉县
原阳	原阳县
延津	延津县
封丘	封丘县
长垣	长垣县
卫辉	卫辉市
辉县	辉县市
焦作	焦作市
解放	解放区
中站	中站区
马村	马村区
山阳	山阳区 山阳县
修武	修武县
博爱	博爱县
武陟	武陟县
温	温县
沁阳	沁阳市
孟州	孟州市
濮阳	濮阳县 濮阳市
华龙	华龙区
清丰	清丰县
南乐	南乐县
范	范县
台前	台前县
许昌	许昌市
魏都	魏都区
建安	建安区
鄢陵	鄢陵县
襄城	襄城县 襄城区
禹州	禹州市
长葛	长葛市
漯河	漯河市
源汇	源汇区
郾城	郾城区
召陵	召陵区
舞阳	舞阳县
临颍	临颍县
三门峡	三门峡市
湖滨	湖滨区
陕州	陕州区
渑池	渑池县
卢氏	卢氏县
义马	义马市
灵宝	灵宝市
南阳	南阳市
宛城	宛城区
卧龙	卧龙区
南召	南召县
方城	方城县
西峡	西峡县
镇平	镇平县
内乡	内乡县
淅川	淅川县
社旗	社旗县
唐河	唐河县
新野	新野县
桐柏	桐柏县
邓州	邓州市
商丘	商丘市
梁园	梁园区
睢阳	睢阳区
民权	民权县
睢	睢县
宁陵	宁陵县
柘城	柘城县
虞城	虞城县
夏邑	夏邑县
永城	永城市
信阳	信阳市
浉河	浉河区
平桥	平桥区
罗山	罗山县
光山	光山县
新	新县
商城	商城县
固始	固始县
潢川	潢川县
淮滨	淮滨县
息	息县
周口	周口市
川汇	川汇区
扶沟	扶沟县
西华	西华县
商水	商水县
沈丘	沈丘县
郸城	郸城县
淮阳	淮阳县
太康	太康县
鹿邑	鹿邑县
项城	项城市
驻马店	驻马店市
驿城	驿城区
西平	西平县
上蔡	上蔡县
平舆	平舆县
正阳	正阳县
确山	确山县
泌阳	泌阳县
汝南	汝南县
遂平	遂平县
新蔡	新蔡县
济源	济源市
湖北	湖北省
武汉	武汉市
江岸	江岸区
江汉	江汉区
硚口	硚口区
汉阳	汉阳区
武昌	武昌区
洪山	洪山区
东西湖	东西湖区
汉南	汉南区
蔡甸	蔡甸区
江夏	江夏区
黄陂	黄陂区
新洲	新洲区
黄石	黄石市
黄石港	黄石港区
西塞山	西塞山区
下陆	下陆区
铁山	铁山区
阳新	阳新县
大冶	大冶市
十堰	十堰市
茅箭	茅箭区
张湾	张湾区
郧阳	郧阳区
郧西	郧西县
竹山	竹山县
竹溪	竹溪县
房	房县
丹江口	丹江口市
宜昌	宜昌市
西陵	西陵区
伍家岗	伍家岗区
点军	点军区
猇亭	猇亭区
夷陵	夷陵区
远安	远安县
秭归	秭归县
宜都	宜都市
当阳	当阳市
枝江	枝江市
襄阳	襄阳市
樊城	樊城区
襄州	襄州区
南漳	南漳县
谷城	谷城县
保康	保康县
老河口	老河口市
枣阳	枣阳市
宜城	宜城市
鄂州	鄂州市
梁子湖	梁子湖区
华容	华容区 华容县
鄂城	鄂城区
荆门	荆门市
东宝	东宝区
掇刀	掇刀区
沙洋	沙洋县
钟祥	钟祥市
京山	京山市
孝感	孝感市
孝南	孝南区
孝昌	孝昌县
大悟	大悟县
云梦	云梦县
应城	应城市
安陆	安陆市
汉川	汉川市
荆州	荆州市 荆州区
沙市	沙市区
公安	公安县
监利	监利县
江陵	江陵县
石首	石首市
洪湖	洪湖市
松滋	松滋市
黄冈	黄冈市
黄州	黄州区
团风	团风县
红安	红安县
罗田	罗田县
英山	英山县
浠水	浠水县
蕲春	蕲春县
黄梅	黄梅县
麻城	麻城市
武穴	武穴市
咸宁	咸宁市
咸安	咸安区
嘉鱼	嘉鱼县
通城	通城县
崇阳	崇阳县
通山	通山县
赤壁	赤壁市
随州	随州市
曾都	曾都区
随	随县
广水	广水市
恩施	恩施市 恩施土家族苗族自治州
利川	利川市
建始	建始县
巴东	巴东县
宣恩	宣恩县
咸丰	咸丰县
来凤	来凤县
鹤峰	鹤峰县
仙桃	仙桃市
潜江	潜江市
天门	天门市
神农架林	神农架林区
湖南	湖南省
长沙	长沙县 长沙市
芙蓉	芙蓉区
天心	天心区
岳麓	岳麓区
开福	开福区
雨花	雨花区
望城	望城区
浏阳	浏阳市
宁乡	宁乡市
株洲	株洲市
荷塘	荷塘区
芦淞	芦淞区
石峰	石峰区
天元	天元区
渌口	渌口区
攸	攸县
茶陵	茶陵县
炎陵	炎陵县
醴陵	醴陵市
湘潭	湘潭市 湘潭县
雨湖	雨湖区
岳塘	岳塘区
湘乡	湘乡市
韶山	韶山市
衡阳	衡阳县 衡阳市
珠晖	珠晖区
雁峰	雁峰区
石鼓	石鼓区
蒸湘	蒸湘区
南岳	南岳区
衡南	衡南县
衡山	衡山县
衡东	衡东县
祁东	祁东县
耒阳	耒阳市
常宁	常宁市
邵阳	邵阳市 邵阳县
双清	双清区
大祥	大祥区
北塔	北塔区
邵东	邵东县
新邵	新邵县
隆回	隆回县
洞口	洞口县
绥宁	绥宁县
新宁	新宁县
武冈	武冈市
岳阳	岳阳县 岳阳市
岳阳楼	岳阳楼区
云溪	云溪区
君山	君山区
湘阴	湘阴县
平江	平江县
汨罗	汨罗市
临湘	临湘市
常德	常德市
武陵	武陵区
鼎城	鼎城区
安乡	安乡县
汉寿	汉寿县
澧	澧县
临澧	临澧县
桃源	桃源县
石门	石门县
津市	津市市
张家界	张家界市
武陵源	武陵源区
慈利	慈利县
桑植	桑植县
益阳	益阳市
资阳	资阳区 资阳市
赫山	赫山区
南	南县
桃江	桃江县
安化	安化县
沅江	沅江市
郴州	郴州市
北湖	北湖区
苏仙	苏仙区
桂阳	桂阳县
宜章	宜章县
永兴	永兴县
嘉禾	嘉禾县
临武	临武县
汝城	汝城县
桂东	桂东县
安仁	安仁县
资兴	资兴市
永州	永州市
零陵	零陵区
冷水滩	冷水滩区
祁阳	祁阳县
双牌	双牌县
道	道县
江永	江永县
宁远	宁远县
蓝山	蓝山县
新田	新田县
怀化	怀化市
鹤城	鹤城区
中方	中方县
沅陵	沅陵县
辰溪	辰溪县
溆浦	溆浦县
会同	会同县
洪江	洪江市
娄底	娄底市
娄星	娄星区
双峰	双峰县
新化	新化县
冷水江	冷水江市
涟源	涟源市
吉首	吉首市
泸溪	泸溪县
凤凰	凤凰县
花垣	花垣县
保靖	保靖县
古丈	古丈县
永顺	永顺县
广东	广东省
广州	广州市
荔湾	荔湾区
越秀	越秀区
海珠	海珠区
天河	天河区
白云	白云区
黄埔	黄埔区
番禺	番禺区
花都	花都区
南沙	南沙区
从化	从化区
增城	增城区
韶关	韶关市
武江	武江区
浈江	浈江区
曲江	曲江区
始兴	始兴县
仁化	仁化县
翁源	翁源县
新丰	新丰县
乐昌	乐昌市
南雄	南雄市
深圳	深圳市
罗湖	罗湖区
福田	福田区
宝安	宝安区
龙岗	龙岗区
盐田	盐田区
龙华	龙华区
坪山	坪山区
光明	光明区
珠海	珠海市
香洲	香洲区
斗门	斗门区
金湾	金湾区
汕头	汕头市
龙湖	龙湖区
金平	金平区 金平苗族瑶族傣族自治县
濠江	濠江区
潮阳	潮阳区
潮南	潮南区
澄海	澄海区
南澳	南澳县
佛山	佛山市
禅城	禅城区
南海	南海区
顺德	顺德区
三水	三水区
高明	高明区
江门	江门市
蓬江	蓬江区
江海	江海区
新会	新会区
台山	台山市
恩平	恩平市
湛江	湛江市
赤坎	赤坎区
霞山	霞山区
坡头	坡头区
麻章	麻章区
遂溪	遂溪县
徐闻	徐闻县
廉江	廉江市
雷州	雷州市
吴川	吴川市
茂名	茂名市
茂南	茂南区
电白	电白区
高州	高州市
化州	化州市
信宜	信宜市
肇庆	肇庆市
端州	端州区
鼎湖	鼎湖区
高要	高要区
广宁	广宁县
怀集	怀集县
封开	封开县
德庆	德庆县
四会	四会市
惠州	惠州市
惠城	惠城区
惠阳	惠阳区
博罗	博罗县
惠东	惠东县
龙门	龙门县
梅州	梅州市
梅江	梅江区
梅县	梅县区
大埔	大埔县
丰顺	丰顺县
五华	五华县 五华区
平远	平远县
蕉岭	蕉岭县
兴宁	兴宁市 兴宁区
汕尾	汕尾市
海丰	海丰县
陆河	陆河县
陆丰	陆丰市
河源	河源市
源城	源城区
紫金	紫金县
龙川	龙川县
连平	连平县
东源	东源县
阳江	阳江市
江城	江城区 江城哈尼族彝族自治县
阳东	阳东区
阳西	阳西县
阳春	阳春市
清远	清远市
清城	清城区
清新	清新区
佛冈	佛冈县
阳山	阳山县
英德	英德市
连州	连州市
东莞	东莞市
潮州	潮州市
湘桥	湘桥区
潮安	潮安区
饶平	饶平县
揭阳	揭阳市
榕城	榕城区
揭东	揭东区
揭西	揭西县
惠来	惠来县
普宁	普宁市
云浮	云浮市
云城	云城区
云安	云安区
郁南	郁南县
罗定	罗定市
南宁	南宁市
青秀	青秀区
江南	江南区
西乡塘	西乡塘区
良庆	良庆区
邕宁	邕宁区
武鸣	武鸣区
隆安	隆安县
马山	马山县
上林	上林县
宾阳	宾阳县
横	横县
柳州	柳州市
城中	城中区
鱼峰	鱼峰区
柳南	柳南区
柳北	柳北区
柳江	柳江区
柳城	柳城县
鹿寨	鹿寨县
融安	融安县
桂林	桂林市
秀峰	秀峰区
叠彩	叠彩区
七星	七星区
雁山	雁山区
临桂	临桂区
阳朔	阳朔县
灵川	灵川县
全州	全州县
永福	永福县
灌阳	灌阳县
资源	资源县
平乐	平乐县
荔浦	荔浦市
梧州	梧州市
万秀	万秀区
长洲	长洲区
龙圩	龙圩区
苍梧	苍梧县
藤	藤县
蒙山	蒙山县
岑溪	岑溪市
北海	北海市
银海	银海区
铁山港	铁山港区
合浦	合浦县
防城港	防城港市
港口	港口区
防城	防城区
上思	上思县
东兴	东兴市 东兴区
钦州	钦州市
钦南	钦南区
钦北	钦北区
灵山	灵山县
浦北	浦北县
贵港	贵港市
港北	港北区
港南	港南区
覃塘	覃塘区
平南	平南县
桂平	桂平市
玉林	玉林市
玉州	玉州区
福绵	福绵区
容	容县
陆川	陆川县
博白	博白县
兴业	兴业县
北流	北流市
百色	百色市
右江	右江区
田阳	田阳县
田东	田东县
平果	平果县
德保	德保县
那坡	那坡县
凌云	凌云县
乐业	乐业县
田林	田林县
靖西	靖西市
贺州	贺州市
八步	八步区
平桂	平桂区
昭平	昭平县
钟山	钟山县 钟山区
河池	河池市
金城江	金城江区
宜州	宜州区
南丹	南丹县
天峨	天峨县
凤山	凤山县
东兰	东兰县
来宾	来宾市
兴宾	兴宾区
忻城	忻城县
象州	象州县
武宣	武宣县
合山	合山市
崇左	崇左市
江州	江州区
扶绥	扶绥县
宁明	宁明县
龙州	龙州县
大新	大新县
天等	天等县
凭祥	凭祥市
海口	海口市
秀英	秀英区
琼山	琼山区
美兰	美兰区
三亚	三亚市
海棠	海棠区
吉阳	吉阳区
天涯	天涯区
崖州	崖州区
三沙	三沙市
儋州	儋州市
五指山	五指山市
琼海	琼海市
文昌	文昌市
万宁	万宁市
东方	东方市
定安	定安县
屯昌	屯昌县
澄迈	澄迈县
临高	临高县
重庆	重庆市
万州	万州区
涪陵	涪陵区
渝中	渝中区
大渡口	大渡口区
沙坪坝	沙坪坝区
九龙坡	九龙坡区
南岸	南岸区
北碚	北碚区
綦江	綦江区
大足	大足区
渝北	渝北区
巴南	巴南区
黔江	黔江区
长寿	长寿区
江津	江津区
合川	合川区
永川	永川区
南川	南川区
璧山	璧山区
铜梁	铜梁区
潼南	潼南区
荣昌	荣昌区
开州	开州区
梁平	梁平区
武隆	武隆区
城口	城口县
丰都	丰都县
垫江	垫江县
忠	忠县
云阳	云阳县
奉节	奉节县
巫山	巫山县
巫溪	巫溪县
四川	四川省
成都	成都市
锦江	锦江区
青羊	青羊区
金牛	金牛区
武侯	武侯区
成华	成华区
龙泉驿	龙泉驿区
青白江	青白江区
新都	新都区
温江	温江区
双流	双流区
郫都	郫都区
金堂	金堂县
大邑	大邑县
蒲江	蒲江县
新津	新津县
都江堰	都江堰市
彭州	彭州市
邛崃	邛崃市
崇州	崇州市
简阳	简阳市
自贡	自贡市
自流井	自流井区
贡井	贡井区
沿滩	沿滩区
荣	荣县
富顺	富顺县
攀枝花	攀枝花市
东	东区
西	西区
仁和	仁和区
米易	米易县
盐边	盐边县
泸州	泸州市
江阳	江阳区
纳溪	纳溪区
龙马潭	龙马潭区
泸	泸县
合江	合江县
叙永	叙永县
古蔺	古蔺县
德阳	德阳市
旌阳	旌阳区
罗江	罗江区
中江	中江县
广汉	广汉市
什邡	什邡市
绵竹	绵竹市
绵阳	绵阳市
涪城	涪城区
游仙	游仙区
安州	安州区
三台	三台县
盐亭	盐亭县
梓潼	梓潼县
平武	平武县
江油	江油市
广元	广元市
利州	利州区
昭化	昭化区
朝天	朝天区
旺苍	旺苍县
青川	青川县
剑阁	剑阁县
苍溪	苍溪县
遂宁	遂宁市
船山	船山区
安居	安居区
蓬溪	蓬溪县
射洪	射洪县
大英	大英县
内江	内江市
威远	威远县
资中	资中县
隆昌	隆昌市
乐山	乐山市
沙湾	沙湾县 沙湾区
五通桥	五通桥区
金口河	金口河区
犍为	犍为县
井研	井研县
夹江	夹江县
沐川	沐川县
峨眉山	峨眉山市
南充	南充市
顺庆	顺庆区
高坪	高坪区
嘉陵	嘉陵区
南部	南部县
营山	营山县
蓬安	蓬安县
仪陇	仪陇县
西充	西充县
阆中	阆中市
眉山	眉山市
东坡	东坡区
彭山	彭山区
仁寿	仁寿县
洪雅	洪雅县
丹棱	丹棱县
青神	青神县
宜宾	宜宾市
翠屏	翠屏区
南溪	南溪区
叙州	叙州区
江安	江安县
高	高县
珙	珙县
筠连	筠连县
兴文	兴文县
屏山	屏山县
广安	广安市 广安区
前锋	前锋区
岳池	岳池县
武胜	武胜县
邻水	邻水县
华蓥	华蓥市
达州	达州市
通川	通川区
达川	达川区
宣汉	宣汉县
开江	开江县
大竹	大竹县
渠	渠县
万源	万源市
雅安	雅安市
雨城	雨城区
名山	名山区
荥经	荥经县
汉源	汉源县
石棉	石棉县
天全	天全县
芦山	芦山县
宝兴	宝兴县
巴中	巴中市
巴州	巴州区
恩阳	恩阳区
通江	通江县
南江	南江县
平昌	平昌县
雁江	雁江区
安岳	安岳县
乐至	乐至县
马尔康	马尔康市
汶川	汶川县
理	理县
茂	茂县
松潘	松潘县
九寨沟	九寨沟县
金川	金川区 金川县
小金	小金县
黑水	黑水县
壤塘	壤塘县
阿坝	阿坝县 阿坝藏族羌族自治州
若尔盖	若尔盖县
红原	红原县
康定	康定市
泸定	泸定县
丹巴	丹巴县
九龙	九龙县
雅江	雅江县
道孚	道孚县
炉霍	炉霍县
甘孜	甘孜县 甘孜藏族自治州
新龙	新龙县
德格	德格县
白玉	白玉县
石渠	石渠县
色达	色达县
理塘	理塘县
巴塘	巴塘县
乡城	乡城县
稻城	稻城县
得荣	得荣县
西昌	西昌市
盐源	盐源县
德昌	德昌县
会理	会理县
会东	会东县
宁南	宁南县
普格	普格县
布拖	布拖县
金阳	金阳县
昭觉	昭觉县
喜德	喜德县
冕宁	冕宁县
越西	越西县
甘洛	甘洛县
美姑	美姑县
雷波	雷波县
贵州	贵州省
贵阳	贵阳市
南明	南明区
云岩	云岩区
花溪	花溪区
乌当	乌当区
观山湖	观山湖区
开阳	开阳县
息烽	息烽县
修文	修文县
清镇	清镇市
六盘水	六盘水市
六枝特	六枝特区
水城	水城县
盘州	盘州市
遵义	遵义市
红花岗	红花岗区
汇川	汇川区
播州	播州区
桐梓	桐梓县
绥阳	绥阳县
正安	正安县
凤冈	凤冈县
湄潭	湄潭县
余庆	余庆县
习水	习水县
赤水	赤水市
仁怀	仁怀市
安顺	安顺市
西秀	西秀区
平坝	平坝区
普定	普定县
毕节	毕节市
七星关	七星关区
大方	大方县
黔西	黔西县
金沙	金沙县
织金	织金县
纳雍	纳雍县
赫章	赫章县
铜仁	铜仁市
碧江	碧江区
万山	万山区
江口	江口县
石阡	石阡县
思南	思南县
德江	德江县
兴义	兴义市
兴仁	兴仁市
普安	普安县
晴隆	晴隆县
贞丰	贞丰县
望谟	望谟县
册亨	册亨县
安龙	安龙县
凯里	凯里市
黄平	黄平县
施秉	施秉县
三穗	三穗县
镇远	镇远县
岑巩	岑巩县
天柱	天柱县
锦屏	锦屏县
剑河	剑河县
黎平	黎平县
榕江	榕江县
从江	从江县
雷山	雷山县
麻江	麻江县
丹寨	丹寨县
都匀	都匀市
福泉	福泉市
荔波	荔波县
贵定	贵定县
瓮安	瓮安县
独山	独山县
平塘	平塘县
罗甸	罗甸县
长顺	长顺县
龙里	龙里县
惠水	惠水县
云南	云南省
昆明	昆明市
盘龙	盘龙区
官渡	官渡区
西山	西山区
东川	东川区
呈贡	呈贡区
晋宁	晋宁区
富民	富民县
宜良	宜良县
嵩明	嵩明县
安宁	安宁市 安宁区
曲靖	曲靖市
麒麟	麒麟区
沾益	沾益区
马龙	马龙区
陆良	陆良县
师宗	师宗县
罗平	罗平县
富源	富源县
会泽	会泽县
宣威	宣威市
玉溪	玉溪市
红塔	红塔区
江川	江川区
澄江	澄江县
通海	通海县
华宁	华宁县
易门	易门县
保山	保山市
隆阳	隆阳区
施甸	施甸县
龙陵	龙陵县
昌宁	昌宁县
腾冲	腾冲市
昭通	昭通市
昭阳	昭阳区
鲁甸	鲁甸县
巧家	巧家县
盐津	盐津县
大关	大关县
永善	永善县
绥江	绥江县
镇雄	镇雄县
彝良	彝良县
威信	威信县
水富	水富市
丽江	丽江市
古城	古城区
永胜	永胜县
华坪	华坪县
普洱	普洱市
思茅	思茅区
临沧	临沧市
临翔	临翔区
凤庆	凤庆县
云	云县
永德	永德县
镇康	镇康县
楚雄	楚雄市 楚雄彝族自治州
双柏	双柏县
牟定	牟定县
南华	南华县
姚安	姚安县
大姚	大姚县
永仁	永仁县
元谋	元谋县
武定	武定县
禄丰	禄丰县
个旧	个旧市
开远	开远市
蒙自	蒙自市
弥勒	弥勒市
建水	建水县
石屏	石屏县
泸西	泸西县
元阳	元阳县
红河	红河县 红河哈尼族彝族自治州
绿春	绿春县
文山	文山市 文山壮族苗族自治州
砚山	砚山县
西畴	西畴县
麻栗坡	麻栗坡县
马关	马关县
丘北	丘北县
广南	广南县
富宁	富宁县
景洪	景洪市
勐海	勐海县
勐腊	勐腊县
大理	大理市 大理白族自治州
祥云	祥云县
宾川	宾川县
弥渡	弥渡县
永平	永平县
洱源	洱源县
剑川	剑川县
鹤庆	鹤庆县
瑞丽	瑞丽市
芒	芒市
梁河	梁河县
盈江	盈江县
陇川	陇川县
泸水	泸水市
福贡	福贡县
香格里拉	香格里拉市
德钦	德钦县
拉萨	拉萨市
城关	城关区
堆龙德庆	堆龙德庆区
达孜	达孜区
林周	林周县
当雄	当雄县
尼木	尼木县
曲水	曲水县
墨竹工卡	墨竹工卡县
日喀则	日喀则市
桑珠孜	桑珠孜区
南木林	南木林县
江孜	江孜县
定日	定日县
萨迦	萨迦县
拉孜	拉孜县
昂仁	昂仁县
谢通门	谢通门县
白朗	白朗县
仁布	仁布县
康马	康马县
定结	定结县
仲巴	仲巴县
亚东	亚东县
吉隆	吉隆县
聂拉木	聂拉木县
萨嘎	萨嘎县
岗巴	岗巴县
昌都	昌都市
卡若	卡若区
江达	江达县
贡觉	贡觉县
类乌齐	类乌齐县
丁青	丁青县
察雅	察雅县
八宿	八宿县
左贡	左贡县
芒康	芒康县
洛隆	洛隆县
边坝	边坝县
林芝	林芝市
巴宜	巴宜区
工布江达	工布江达县
米林	米林县
墨脱	墨脱县
波密	波密县
察隅	察隅县
朗	朗县
山南	山南市
乃东	乃东区
扎囊	扎囊县
贡嘎	贡嘎县
桑日	桑日县
琼结	琼结县
曲松	曲松县
措美	措美县
洛扎	洛扎县
加查	加查县
隆子	隆子县
错那	错那县
浪卡子	浪卡子县
那曲	那曲市
色尼	色尼区
嘉黎	嘉黎县
比如	比如县
聂荣	聂荣县
安多	安多县
申扎	申扎县
索	索县
班戈	班戈县
巴青	巴青县
尼玛	尼玛县
双湖	双湖县
阿里地	阿里地区
普兰	普兰县
札达	札达县
噶尔	噶尔县
日土	日土县
革吉	革吉县
改则	改则县
措勤	措勤县
陕西	陕西省
碑林	碑林区
莲湖	莲湖区
灞桥	灞桥区
未央	未央区
雁塔	雁塔区
阎良	阎良区
临潼	临潼区
高陵	高陵区
鄠邑	鄠邑区
蓝田	蓝田县
周至	周至县
铜川	铜川市
王益	王益区
印台	印台区
耀州	耀州区
宜君	宜君县
宝鸡	宝鸡市
渭滨	渭滨区
金台	金台区
陈仓	陈仓区
凤翔	凤翔县
岐山	岐山县
扶风	扶风县
眉	眉县
陇	陇县
千阳	千阳县
麟游	麟游县
凤	凤县
太白	太白县
咸阳	咸阳市
秦都	秦都区
杨陵	杨陵区
渭城	渭城区
三原	三原县
泾阳	泾阳县
乾	乾县
礼泉	礼泉县
永寿	永寿县
长武	长武县
旬邑	旬邑县
淳化	淳化县
武功	武功县
兴平	兴平市
彬州	彬州市
渭南	渭南市
临渭	临渭区
华州	华州区
潼关	潼关县
大荔	大荔县
合阳	合阳县
澄城	澄城县
蒲城	蒲城县
白水	白水县
富平	富平县
韩城	韩城市
华阴	华阴市
延安	延安市
宝塔	宝塔区
安塞	安塞区
延长	延长县
延川	延川县
子长	子长县
志丹	志丹县
吴起	吴起县
甘泉	甘泉县
富	富县
洛川	洛川县
宜川	宜川县
黄龙	黄龙县
黄陵	黄陵县
汉中	汉中市
汉台	汉台区
南郑	南郑区
城固	城固县
洋	洋县
西乡	西乡县
勉	勉县
宁强	宁强县
略阳	略阳县
镇巴	镇巴县
留坝	留坝县
佛坪	佛坪县
榆林	榆林市
榆阳	榆阳区
横山	横山区
府谷	府谷县
靖边	靖边县
定边	定边县
绥德	绥德县
米脂	米脂县
佳	佳县
吴堡	吴堡县
清涧	清涧县
子洲	子洲县
神木	神木市
安康	安康市
汉滨	汉滨区
汉阴	汉阴县
石泉	石泉县
宁陕	宁陕县
紫阳	紫阳县
岚皋	岚皋县
平利	平利县
镇坪	镇坪县
旬阳	旬阳县
白河	白河县
商洛	商洛市
商州	商州区
洛南	洛南县
丹凤	丹凤县
商南	商南县
镇安	镇安县
柞水	柞水县
甘肃	甘肃省
兰州	兰州市
七里河	七里河区
西固	西固区
红古	红古区
永登	永登县
皋兰	皋兰县
榆中	榆中县
嘉峪关	嘉峪关市
金昌	金昌市
永昌	永昌县
白银	白银区 白银市
平川	平川区
靖远	靖远县
会宁	会宁县
景泰	景泰县
天水	天水市
秦州	秦州区
麦积	麦积区
清水	清水县
秦安	秦安县
甘谷	甘谷县
武山	武山县
武威	武威市
凉州	凉州区
民勤	民勤县
古浪	古浪县
张掖	张掖市
甘州	甘州区
民乐	民乐县
临泽	临泽县
高台	高台县
山丹	山丹县
平凉	平凉市
崆峒	崆峒区
泾川	泾川县
灵台	灵台县
崇信	崇信县
庄浪	庄浪县
静宁	静宁县
华亭	华亭市
酒泉	酒泉市
肃州	肃州区
金塔	金塔县
瓜州	瓜州县
玉门	玉门市
敦煌	敦煌市
庆阳	庆阳市
西峰	西峰区
庆城	庆城县
环	环县
华池	华池县
合水	合水县
正宁	正宁县
宁	宁县
镇原	镇原县
定西	定西市
安定	安定区
通渭	通渭县
陇西	陇西县
渭源	渭源县
临洮	临洮县
漳	漳县
岷	岷县
陇南	陇南市
武都	武都区
成	成县
文	文县
宕昌	宕昌县
康	康县
西和	西和县
礼	礼县
徽	徽县
两当	两当县
临夏	临夏市 临夏县 临夏回族自治州
康乐	康乐县
永靖	永靖县
广河	广河县
和政	和政县
合作	合作市
临潭	临潭县
卓尼	卓尼县
舟曲	舟曲县
迭部	迭部县
玛曲	玛曲县
碌曲	碌曲县
夏河	夏河县
青海	青海省
西宁	西宁市
城东	城东区
城西	城西区
城北	城北区
湟中	湟中县
湟源	湟源县
海东	海东市
乐都	乐都区
平安	平安区
祁连	祁连县
海晏	海晏县
刚察	刚察县
同仁	同仁县
尖扎	尖扎县
泽库	泽库县
共和	共和县
同德	同德县
贵德	贵德县
兴海	兴海县
贵南	贵南县
玛沁	玛沁县
班玛	班玛县
甘德	甘德县
达日	达日县
久治	久治县
玛多	玛多县
玉树	玉树市 玉树藏族自治州
杂多	杂多县
称多	称多县
治多	治多县
囊谦	囊谦县
曲麻莱	曲麻莱县
格尔木	格尔木市
德令哈	德令哈市
茫崖	茫崖市
乌兰	乌兰县
都兰	都兰县
天峻	天峻县
银川	银川市
兴庆	兴庆区
西夏	西夏区
金凤	金凤区
永宁	永宁县
贺兰	贺兰县
灵武	灵武市
石嘴山	石嘴山市
大武口	大武口区
惠农	惠农区
平罗	平罗县
吴忠	吴忠市
利通	利通区
红寺堡	红寺堡区
盐池	盐池县
同心	同心县
青铜峡	青铜峡市
固原	固原市
原州	原州区
西吉	西吉县
隆德	隆德县
泾源	泾源县
彭阳	彭阳县
中卫	中卫市
沙坡头	沙坡头区
中宁	中宁县
海原	海原县
乌鲁木齐	乌鲁木齐县 乌鲁木齐市
天山	天山区
沙依巴克	沙依巴克区
新市	新市区
水磨沟	水磨沟区
头屯河	头屯河区
达坂城	达坂城区
米东	米东区
克拉玛依	克拉玛依区 克拉玛依市
独山子	独山子区
白碱滩	白碱滩区
乌尔禾	乌尔禾区
吐鲁番	吐鲁番市
高昌	高昌区
鄯善	鄯善县
托克逊	托克逊县
哈密	哈密市
伊州	伊州区
伊吾	伊吾县
昌吉	昌吉市 昌吉回族自治州
阜康	阜康市
呼图壁	呼图壁县
玛纳斯	玛纳斯县
奇台	奇台县
吉木萨尔	吉木萨尔县
博乐	博乐市
阿拉山口	阿拉山口市
精河	精河县
温泉	温泉县
库尔勒	库尔勒市
轮台	轮台县
尉犁	尉犁县
若羌	若羌县
且末	且末县
和静	和静县
和硕	和硕县
博湖	博湖县
阿克苏地	阿克苏地区
阿克苏	阿克苏市
温宿	温宿县
库车	库车县
沙雅	沙雅县
新和	新和县
拜城	拜城县
乌什	乌什县
阿瓦提	阿瓦提县
柯坪	柯坪县
阿图什	阿图什市
阿克陶	阿克陶县
阿合奇	阿合奇县
乌恰	乌恰县
喀什地	喀什地区
喀什	喀什市
疏附	疏附县
疏勒	疏勒县
英吉沙	英吉沙县
泽普	泽普县
莎车	莎车县
叶城	叶城县
麦盖提	麦盖提县
岳普湖	岳普湖县
伽师	伽师县
巴楚	巴楚县
和田地	和田地区
和田	和田县 和田市
墨玉	墨玉县
皮山	皮山县
洛浦	洛浦县
策勒	策勒县
于田	于田县
民丰	民丰县
伊宁	伊宁县 伊宁市
奎屯	奎屯市
霍尔果斯	霍尔果斯市
霍城	霍城县
巩留	巩留县
新源	新源县
昭苏	昭苏县
特克斯	特克斯县
尼勒克	尼勒克县
塔城地	塔城地区
塔城	塔城市
乌苏	乌苏市
额敏	额敏县
托里	托里县
裕民	裕民县
阿勒泰地	阿勒泰地区
阿勒泰	阿勒泰市
布尔津	布尔津县
富蕴	富蕴县
福海	福海县
哈巴河	哈巴河县
青河	青河县
吉木乃	吉木乃县
石河子	石河子市
阿拉尔	阿拉尔市
图木舒克	图木舒克市
五家渠	五家渠市
北屯	北屯市
铁门关	铁门关市
双河	双河市
可克达拉	可克达拉市
昆玉	昆玉市
台湾	台湾省
广西	广西壮族自治区
内蒙古	内蒙古自治区
西藏	西藏自治区
新疆	新疆维吾尔自治区
宁夏	宁夏回族自治区
澳门	澳门特别行政区
香港	香港特别行政区
台	台湾省
青龙	青龙满族自治县
丰宁	丰宁满族自治县
围场	围场满族蒙古族自治县
孟村	孟村回族自治县
大厂	大厂回族自治县
莫力达瓦	莫力达瓦达斡尔族自治旗
鄂伦春	鄂伦春自治旗
鄂温	鄂温克族自治旗
岫岩	岫岩满族自治县
新宾	新宾满族自治县
清原	清原满族自治县
桓仁	桓仁满族自治县
宽甸	宽甸满族自治县
喀喇沁	喀喇沁左翼蒙古族自治县
伊通	伊通满族自治县
长白	长白朝鲜族自治县
前郭尔罗斯	前郭尔罗斯蒙古族自治县
延边	延边朝鲜族自治州
杜尔伯特	杜尔伯特蒙古族自治县
景宁	景宁畲族自治县
长阳	长阳土家族自治县
五峰	五峰土家族自治县
城步	城步苗族自治县
江华	江华瑶族自治县
麻阳	麻阳苗族自治县
新晃	新晃侗族自治县
芷江	芷江侗族自治县
靖州	靖州苗族侗族自治县
通道	通道侗族自治县
湘西	湘西土家族苗族自治州
乳源	乳源瑶族自治县
连南	连南瑶族自治县
融水	融水苗族自治县
三江	三江侗族自治县
龙胜	龙胜各族自治县
恭城	恭城瑶族自治县
隆林	隆林各族自治县
富川	富川瑶族自治县
罗城仫	罗城仫佬族自治县
环江	环江毛南族自治县
巴马	巴马瑶族自治县
都安	都安瑶族自治县
大化	大化瑶族自治县
金秀	金秀瑶族自治县
白沙	白沙黎族自治县
乐东	乐东黎族自治县
陵水	陵水黎族自治县
保亭	保亭黎族苗族自治县
琼中	琼中黎族苗族自治县
石柱	石柱土家族自治县
秀山	秀山土家族苗族自治县
酉阳	酉阳土家族苗族自治县
彭水	彭水苗族土家族自治县
北川	北川羌族自治县
峨边	峨边彝族自治县
马边	马边彝族自治县
凉山	凉山彝族自治州
木里	木里藏族自治县
道真	道真仡佬族苗族自治县
务川	务川仡佬族苗族自治县
镇宁	镇宁布依族苗族自治县
关岭	关岭布依族苗族自治县
紫云	紫云苗族布依族自治县
威宁	威宁彝族回族苗族自治县
玉屏	玉屏侗族自治县
印江	印江土家族苗族自治县
沿河	沿河土家族自治县
松桃	松桃苗族自治县
黔西南	黔西南布依族苗族自治州
黔西南州	黔西南布依族苗族自治州
黔东南	黔东南苗族侗族自治州
黔东南州	黔东南苗族侗族自治州
黔南	黔南布依族苗族自治州
三都	三都水族自治县
石林	石林彝族自治县
禄劝	禄劝彝族苗族自治县
寻甸	寻甸回族彝族自治县
峨山	峨山彝族自治县
新平	新平彝族傣族自治县
元江	元江哈尼族彝族傣族自治县
玉龙	玉龙纳西族自治县
宁蒗	宁蒗彝族自治县
宁洱	宁洱哈尼族彝族自治县
墨江	墨江哈尼族自治县
景东	景东彝族自治县
景谷	景谷傣族彝族自治县
镇沅	镇沅彝族哈尼族拉祜族自治县
孟连	孟连傣族拉祜族佤族自治县
澜沧	澜沧拉祜族自治县
西盟	西盟佤族自治县
双江	双江拉祜族佤族布朗族傣族自治县
耿马	耿马傣族佤族自治县
沧源	沧源佤族自治县
屏边	屏边苗族自治县
西双版纳	西双版纳傣族自治州
漾濞	漾濞彝族自治县
南涧	南涧彝族自治县
巍山	巍山彝族回族自治县
德宏	德宏傣族景颇族自治州
怒江	怒江傈僳族自治州
贡山	贡山独龙族怒族自治县
兰坪	兰坪白族普米族自治县
迪庆	迪庆藏族自治州
维西	维西傈僳族自治县
张家川	张家川回族自治县
天祝	天祝藏族自治县
肃南	肃南裕固族自治县
肃北	肃北蒙古族自治县
阿克塞	阿克塞哈萨克族自治县
积石山	积石山保安族东乡族撒拉族自治县
民和	民和回族土族自治县
互助	互助土族自治县
化隆	化隆回族自治县
循化	循化撒拉族自治县
海北	海北藏族自治州
门源	门源回族自治县
黄南	黄南藏族自治州
果洛	果洛藏族自治州
海西	海西蒙古族藏族自治州
巴里	巴里坤哈萨克自治县
木垒	木垒哈萨克自治县
博尔塔拉	博尔塔拉蒙古自治州
巴音郭楞	巴音郭楞蒙古自治州
焉耆	焉耆回族自治县
克孜勒苏	克孜勒苏柯尔克孜自治州
塔什库尔	塔什库尔干塔吉克自治县
伊犁	伊犁哈萨克自治州
察布查尔	察布查尔锡伯自治县
和布克赛尔	和布克赛尔蒙古自治县