青龙满族自治县	青龙满族自治县
丰宁满族自治县	丰宁满族自治县
宽城满族自治县	宽城满族自治县
围场满族蒙古族自治县	围场满族蒙古族自治县
孟村回族自治县	孟村回族自治县
大厂回族自治县	大厂回族自治县
内蒙古自治区	内蒙古自治区
莫力达瓦达斡尔族自治旗	莫力达瓦达斡尔族自治旗
鄂伦春自治旗	鄂伦春自治旗
鄂温克族自治旗	鄂温克族自治旗
岫岩满族自治县	岫岩满族自治县
新宾满族自治县	新宾满族自治县
清原满族自治县	清原满族自治县
本溪满族自治县	本溪满族自治县
桓仁满族自治县	桓仁满族自治县
宽甸满族自治县	宽甸满族自治县
阜新蒙古族自治县	阜新蒙古族自治县
喀喇沁左翼蒙古族自治县	喀喇沁左翼蒙古族自治县
伊通满族自治县	伊通满族自治县
长白朝鲜族自治县	长白朝鲜族自治县
前郭尔罗斯蒙古族自治县	前郭尔罗斯蒙古族自治县
延边朝鲜族自治州	延边朝鲜族自治州
杜尔伯特蒙古族自治县	杜尔伯特蒙古族自治县
景宁畲族自治县	景宁畲族自治县
长阳土家族自治县	长阳土家族自治县
五峰土家族自治县	五峰土家族自治县
恩施土家族苗族自治州	恩施土家族苗族自治州
城步苗族自治县	城步苗族自治县
江华瑶族自治县	江华瑶族自治县
麻阳苗族自治县	麻阳苗族自治县
新晃侗族自治县	新晃侗族自治县
芷江侗族自治县	芷江侗族自治县
靖州苗族侗族自治县	靖州苗族侗族自治县
通道侗族自治县	通道侗族自治县
湘西土家族苗族自治州	湘西土家族苗族自治州
乳源瑶族自治县	乳源瑶族自治县
连山壮族瑶族自治县	连山壮族瑶族自治县
连南瑶族自治县	连南瑶族自治县
广西壮族自治区	广西壮族自治区
融水苗族自治县	融水苗族自治县
三江侗族自治县	三江侗族自治县
龙胜各族自治县	龙胜各族自治县
恭城瑶族自治县	恭城瑶族自治县
隆林各族自治县	隆林各族自治县
富川瑶族自治县	富川瑶族自治县
罗城仫佬族自治县	罗城仫佬族自治县
环江毛南族自治县	环江毛南族自治县
巴马瑶族自治县	巴马瑶族自治县
都安瑶族自治县	都安瑶族自治县
大化瑶族自治县	大化瑶族自治县
金秀瑶族自治县	金秀瑶族自治县
白沙黎族自治县	白沙黎族自治县
昌江黎族自治县	昌江黎族自治县
乐东黎族自治县	乐东黎族自治县
陵水黎族自治县	陵水黎族自治县
保亭黎族苗族自治县	保亭黎族苗族自治县
琼中黎族苗族自治县	琼中黎族苗族自治县
石柱土家族自治县	石柱土家族自治县
秀山土家族苗族自治县	秀山土家族苗族自治县
酉阳土家族苗族自治县	酉阳土家族苗族自治县
彭水苗族土家族自治县	彭水苗族土家族自治县
北川羌族自治县	北川羌族自治县
峨边彝族自治县	峨边彝族自治县
马边彝族自治县	马边彝族自治县
阿坝藏族羌族自治州	阿坝藏族羌族自治州
甘孜藏族自治州	甘孜藏族自治州
凉山彝族自治州	凉山彝族自治州
木里藏族自治县	木里藏族自治县
道真仡佬族苗族自治县	道真仡佬族苗族自治县
务川仡佬族苗族自治县	务川仡佬族苗族自治县
镇宁布依族苗族自治县	镇宁布依族苗族自治县
关岭布依族苗族自治县	关岭布依族苗族自治县
紫云苗族布依族自治县	紫云苗族布依族自治县
威宁彝族回族苗族自治县	威宁彝族回族苗族自治县
玉屏侗族自治县	玉屏侗族自治县
印江土家族苗族自治县	印江土家族苗族自治县
沿河土家族自治县	沿河土家族自治县
松桃苗族自治县	松桃苗族自治县
黔西南布依族苗族自治州	黔西南布依族苗族自治州
黔东南苗族侗族自治州	黔东南苗族侗族自治州
黔南布依族苗族自治州	黔南布依族苗族自治州
三都水族自治县	三都水族自治县
石林彝族自治县	石林彝族自治县
禄劝彝族苗族自治县	禄劝彝族苗族自治县
寻甸回族彝族自治县	寻甸回族彝族自治县
峨山彝族自治县	峨山彝族自治县
新平彝族傣族自治县	新平彝族傣族自治县
元江哈尼族彝族傣族自治县	元江哈尼族彝族傣族自治县
玉龙纳西族自治县	玉龙纳西族自治县
宁蒗彝族自治县	宁蒗彝族自治县
宁洱哈尼族彝族自治县	宁洱哈尼族彝族自治县
墨江哈尼族自治县	墨江哈尼族自治县
景东彝族自治县	景东彝族自治县
景谷傣族彝族自治县	景谷傣族彝族自治县
镇沅彝族哈尼族拉祜族自治县	镇沅彝族哈尼族拉祜族自治县
江城哈尼族彝族自治县	江城哈尼族彝族自治县
孟连傣族拉祜族佤族自治县	孟连傣族拉祜族佤族自治县
澜沧拉祜族自治县	澜沧拉祜族自治县
西盟佤族自治县	西盟佤族自治县
双江拉祜族佤族布朗族傣族自治县	双江拉祜族佤族布朗族傣族自治县
耿马傣族佤族自治县	耿马傣族佤族自治县
沧源佤族自治县	沧源佤族自治县
楚雄彝族自治州	楚雄彝族自治州
红河哈尼族彝族自治州	红河哈尼族彝族自治州
屏边苗族自治县	屏边苗族自治县
金平苗族瑶族傣族自治县	金平苗族瑶族傣族自治县
河口瑶族自治县	河口瑶族自治县
文山壮族苗族自治州	文山壮族苗族自治州
西双版纳傣族自治州	西双版纳傣族自治州
大理白族自治州	大理白族自治州
漾濞彝族自治县	漾濞彝族自治县
南涧彝族自治县	南涧彝族自治县
巍山彝族回族自治县	巍山彝族回族自治县
德宏傣族景颇族自治州	德宏傣族景颇族自治州
怒江傈僳族自治州	怒江傈僳族自治州
贡山独龙族怒族自治县	贡山独龙族怒族自治县
兰坪白族普米族自治县	兰坪白族普米族自治县
迪庆藏族自治州	迪庆藏族自治州
维西傈僳族自治县	维西傈僳族自治县
西藏自治区	西藏自治区
张家川回族自治县	张家川回族自治县
天祝藏族自治县	天祝藏族自治县
肃南裕固族自治县	肃南裕固族自治县
肃北蒙古族自治县	肃北蒙古族自治县
阿克塞哈萨克族自治县	阿克塞哈萨克族自治县
临夏回族自治州	临夏回族自治州
东乡族自治县	东乡族自治县
积石山保安族东乡族撒拉族自治县	积石山保安族东乡族撒拉族自治县
甘南藏族自治州	甘南藏族自治州
大通回族土族自治县	大通回族土族自治县
民和回族土族自治县	民和回族土族自治县
互助土族自治县	互助土族自治县
化隆回族自治县	化隆回族自治县
循化撒拉族自治县	循化撒拉族自治县
海北藏族自治州	海北藏族自治州
门源回族自治县	门源回族自治县
黄南藏族自治州	黄南藏族自治州
河南蒙古族自治县	河南蒙古族自治县
海南藏族自治州	海南藏族自治州
果洛藏族自治州	果洛藏族自治州
玉树藏族自治州	玉树藏族自治州
海西蒙古族藏族自治州	海西蒙古族藏族自治州
宁夏回族自治区	宁夏回族自治区
新疆维吾尔自治区	新疆维吾尔自治区
巴里坤哈萨克自治县	巴里坤哈萨克自治县
昌吉回族自治州	昌吉回族自治州
木垒哈萨克自治县	木垒哈萨克自治县
博尔塔拉蒙古自治州	博尔塔拉蒙古自治州
巴音郭楞蒙古自治州	巴音郭楞蒙古自治州
焉耆回族自治县	焉耆回族自治县
克孜勒苏柯尔克孜自治州	克孜勒苏柯尔克孜自治州
塔什库尔干塔吉克自治县	塔什库尔干塔吉克自治县
伊犁哈萨克自治州	伊犁哈萨克自治州
察布查尔锡伯自治县	察布查尔锡伯自治县
和布克赛尔蒙古自治县	和布克赛尔蒙古自治县
香港特别行政区	香港特别行政区
澳门特别行政区	澳门特别行政区